1111111111111111111
1E1000000000000C001
1D10010100100000101
1010010010101010001
1P0000000C00C00001
1111111111111111111