111111111111111111
1E1000000000000C00
101001010010000010
101001001010101000
1P0000000C00C00000
111111111111111111