1111111111111
10000000000C1
1000011111001
1P0010E000001
1111111111111